BBBBBBBBBBBBBBBBBBBBBBBB
BBOOOOOBBBBBBBBBBBBBBBBB
BBBBBBBBBBBBBBBBBBOOOBBB
BBBBBBBBBBBBBBBBBBBBBBJB
BBBMBBBBBBBBBBBBBBBBOBBB
BBBBBBBBBBBBBBBBBBBBBBBB
BBBMBBBBBBBBBBBBBBBBBBBB
BBBBBBBBBBBBBBBBBBBBBBBB
BBBMOBBBBBBBBBBBBBBBBBBB
BBBBBBMBBBBBBOBBBBBBBBBB
BBBBBBBBBBBBBBMBBMBBBBBB
BBBBBBMBBBBBBBBBBBBBBBBB
BOOOOBBBBOOBBBBBBBBBBBBB
BBBBBBBBBBBBBBBBOBBBBBBB
BBBBBBBMBBBBBBBBBBBBBBBB
BBBBBBBBBBBBBBBBBBBBBBBB


