BBBBBBBBBBBBBBBBBBBBBBBB
OOOOOOOBBBBBBBBBBBBBBBBB
BBBBBBBBBBBBBBBBBBOOOBBB
BBBBBBBBBBBBMBBBBBBBBBJB
BBBBBBBBBBBBBBBBBBBBOBBB
BOOOOBBBBBBBBBOOOOOBBBBB
BBBBBOBBBBBBBBBBBBBBBBBB
BBBBBBBBBBBBBBBBBBBBBBBB
BBBBBBBBBBBBBBBBBBBBBBBB
BBBBBBMBBBBBBBBBOOOOOOBB
OOOBBBBBBBBBBBMBBMBBBBBB
BBBBBBMBBBBBBBBBBBBBBBBB
BBBBBBBBBOOBBBBBBBBBBBBB
BBBBBBOOOOOOOOBBBBBBBBBB
BBBBBBBBBBBBBBBBBBBBBBBB
BBBBBBBBBBBBBBBBBBBBBBBB


