BBBBBBBBBBBBBBBBBBBBBBBB
OOOOOOOBBBBBBBBBBBBBBBBB
BBBBBBBBBBBBBBBBBBOOOBBB
BBBBBBBBBBBBMBBBBBBBBBJB
BBBMBBBBBBBBBBBBBBBBOBBB
BBBBBBBBBBBBBBOOOOOBBBBB
BBBMBBBBBBBBBBBBBBBBBBBB
BBBBBBBBBBBBBBBBBBBBBBBB
BBBMMBBBBBBBBBBBBBBBBBBB
BBBBBBMBBBBBBOOOOOOOOBBB
OOOBBBBBBBBBBBMBBMBBBBBB
BBBBBBMBBBBBBBBBBBBBBBBB
BBBBBBBBBOOBBBBBBBBBBBBB
BBBBBBOOOOOOOOBBBBBBBBBB
BBBBBBBBBBBBBBBBBBBBBBBB
BBBBBBBBBBBBBBBBBBBBBBBB


